map_size=8,8;
map_tiles=
11111111
10000001
10011001
10011001
10111101
$p1$0100101
$p3$0000001
11111111
;