map_size=7,10;
map_tiles=
1111111
1000001
1000001
1000001
1011101
1010101
1010001
1000101
1000001
1101111
;
player_spawn=2,9;
room_down=1;